ID	Name
ClvchrdK	ClvichordK
GrandP #	GrndPiano#
GrndPnoK	GrndPianoK
MelloGrP	MelloGrPno
PianoStr	PianoStrng
DreamPno	DreamPiano
ConGrand	Con. Grand
ConGrndK	Con.GrandK
DblConGr	DblConGrnd
OldAcPno	OldAcPiano
GrandP *	LvGrandPno
StGrdPf*	LvStGrdPno
BriteP #	BritPiano#
BritPnoK	BritPianoK
StBrtPno	StBritePno
DetBrPno	Det.BrtPno
MIDI Gr4	MIDIGrand4
EGndPnoK	ElGrndPnoK
Det.CP80	DetuneCP80
LayerCP1	LayeredCP1
LayerCP2	LayeredCP2
HnkyTnkK	HonkyTonkK
EPiano1#	El.Piano1#
EPiano1K	ElPiano 1K
MellowEP	Mellow EP.
ChorusEP	Chorus EP.
HardEPno	Hard ElPno
VX E.Pno	VX ElPiano
60sElPno	60s' ElPno
Diploid1	Diploid 1
Diploid2	Diploid 2
Diploid3	Diploid 3
Easy EP	Easy ElPno
Cheap EP	Cheap EP.
TrmStcEP	TremStcsEP
GalaxyEP	Galaxy EP
Trem.EP*	Trem. EP *
EPiano2#	El.Piano2#
EPiano2K	ElPiano 2K
Chor.EP2	ChorusEP.2
DX Hard	DX Hard EP
DXLegend	DX Legend
DXAnalog	DX Analog
DX Kt EP	DX Koto EP
VX EPno2	VX EPiano2
DX Malet	DX Mallet
Shirakwa	Shirakawa
ShivrDX+	ShiverDX +
DXModern	DX Modern
HyprTine	HyperTines
BVenusEP	BelVenusEP
HpschrdK	HrpsichrdK
Hpschrd2	Hrpsichrd2
Hpschrd3	Hrpsichrd3
Clavi. #	Clavinet #
ClvinetK	Clavinet K
ClaviWah	ClvchrdWah
PulseClv	PulseClavi
PiercClv	PierceClav
SupClavi	SuperClavi
HardyPlk	HardyPluck
BrtClav*	Brt.Clavi*
FM Celst	FM Celesta
S. Orgel	SmallOrgel
VibrafnK	VibrafoneK
HardVibr	HardVibrfn
MarimbaK	Marimba K
SMarimba	SineMrimba
Balafone	Balaphone
Log Drum	Log Drums
ChrchBel	ChurchBell
Dulcmer2	Dulcimer 2
DrawOrg#	DrawOrgan#
DetDrwOr	DetDrawOrg
60sDrOrg	60sDrawOrg
60sDrOr2	60sDrawOr2
70sDrOrg	70sDrawOrg
DrawOrg2	DrawOrgan2
60sDrOr3	60sDrawOr3
EvenBar	Even Bar
Organ Ba	Organ Bass
70sDrOr2	70sDrawOr2
CheezOrg	CheeseOrgn
DrawOrg3	DrawOrgan3
ClkGspOr	ClikGospOr
Mood Org	Mood Organ
JazzOrg1	JazzOrgan1
JazzOrg2	JazzOrgan2
JazzOrg3	JazzOrgan3
PercOrg#	PercOrgan#
70sPcOrg	70sPercOrg
DetPrcOr	DetPercOrg
LightOrg	LightOrgan
PercOrg2	PercOrgan2
WarmJazz	WarmJazzOr
BeepOrgn	Beep Organ
RockOrg#	RockOrgan#
RotaryOr	RotaryOrgn
SlwRotar	SlowRotary
FstRotar	FastRotary
RockOrg*	RockOrgan*
ChurOrg3	ChurchOrg3
ChurOrg2	ChurchOrg2
NotreDam	Notre Dame
OrgFlute	OrganFlute
TrmOrgFl	TrmOrFlute
PuffOrgn	Puff Organ
AccordIt	AcordionIt
Harmo. 2	Harmonica2
TngoAcd2	TangoAcod2
NylonGt#	Nylon Gt.#
NylonGt2	Nylon Gt.2
NylonGt3	Nylon Gt.3
VelGtHrm	VelGtHrmnx
DecayEsG	DecayEspGt
ClassGt*	ClassicGt*
SteelGt#	Steel Gt.#
SteelGt2	Steel Gt.2
12StrGtr	12-Str Gt.
Nyln&Stl	Nyln&Steel
Stl&Body	Steel&Body
Nashv.Gt	Nashville
OldSampl	Old Sample
JazzGtr#	Jazz Gtr.#
MelloGtr	Mellow Gt.
Jazz Amp	JazzGtrAmp
OctPlate	Oct. Plate
MidSJazz	MidSupJzGt
NekRough	Neck.Rough
JazzGtr*	Jazz Gtr.*
PdlSteel	PedalSteel
ClnGtr**	CleanGtr**
ChorusGt	Chorus Gt.
CleanGt2	Clean Gt.2
MidT.Gtr	MidToneGt.
MidTGtSt	MidTnGtrSt
NasalGtr	Nasal Gtr.
HammrMid	Mid Hammer
HammrBrg	BridgeHamr
HammrDbl	Dbl Hammer
HammrSt.	St. Hammer
60sClnGt	60sClnGtr.
MutedGt#	Muted Gt.#
Funk Gtr	Funk Gtr 1
MuteStlG	MuteSteelG
FunkGtr2	Funk Gtr 2
WrenchGt	Wrench Gtr
Heavy Wr	HeavyWrnch
GrvyMtGt	GroovyMtGt
Mu.DstGt	MuteDistGt
Ovrdriv#	Overdrive#
OvdrGtDt	OvdrGtrDet
Gt.Pinch	Gtr. Pinch
BrtMnhtn	BriteMnhtn
Ovrdriv*	Overdrive*
Dist.Gt#	Dist. Gt.#
DstRthmG	DistRthmGt
DistGtr2	Dist.Gtr 2
DistGtr3	Dist.Gtr 3
PowerGt2	PowerGtr.2
PowerGtr	Power Gtr.
Dst.5ths	Dist. 5ths
FeedbkGt	FeedbackGt
FeedbkG2	FeedbackG2
TwinDist	TwinDistGt
RckRthm2	RockRthm 2
RockRthm	RockRhythm
Bite +	Bite Plus
AcouHarm	Acou.Harmo
GtFeedbk	GtFeedback
GtrHrmo2	GtrHarmo 2
Acou.Ba#	Acou.Bass#
JazzRthm	JazzRhythm
PkAcouBa	PickAcouBa
VXUprght	VX Upright
BostonBa	BostonBass
WalkSyBa	Walk'SynBa
FingrBa#	FingerBas#
FingrDrk	FingerBsDk
FlangrBa	Flanger Ba
Ba&DstEG	Ba&DstEGtr
FngrSlap	FingerSlap
FngrBas2	FingerBas2
Jazzy Ba	Jazzy Bass
Mod Bass	Modul.Bass
RezChase	Reso.Chase
BlueBass	Blues Bass
FW EBass	FltWdEBass
MelFgrBa	MelFingrBa
Alp.Bass	AlpineBass
PickBas2	PickedBas2
M.PkBass	MutePkBass
HardPick	Hard Pick
RzHardPk	ResoHardPk
PickBas*	PickedBas*
Fretles#	FretlesBs#
Fretles2	FretlesBs2
Fretles3	FretlesBs3
Fretles4	FretlesBs4
Pwr.Fret	PwrFretles
TalkinBa	TalkinBass
SynFretl	SynFretles
SmthFrtl	SmthFrtles
FrtlsBa*	FrtlesBas*
SlapBas#	Slap Bass#
ResoSlap	Reson.Slap
PunchThm	PunchThmBs
Thum&Slp	Thumb&Slap
SlapBa2#	SlapBass2#
VeloSlap	VeloSwSlap
FunkBas*	Funk Bass*
SynBs1Dk	SynBass1Dk
FastResB	FastResoBs
AcidBass	Acid Bass
ResoBass	Reson.Bass
MPulseBa	Mt.PulseBa
Clv.Bass	Clavi Bass
TechnoBa	TechnoBass
KickBass	Kick Bass
OrbitrBa	Orbiter Ba
Sqr.Bass	SquareBass
RubberBa	RubberBass
FishBass	Fish Bass
HardReso	HardReson.
PlutoBas	Pluto Bass
StimuliB	Stimuli Bs
TkinPuls	TalkinPuls
SweepSqr	Sweep Sqr.
Reso Sqr	Reso.SqrBa
MnplisBa	MnplisBass
Miami Ba	Miami Bass
HammerBa	HammerBass
AnalogBa	AnalogBass
RezoBass	Rezzo Bass
MelloSBa	MelloSynBs
Seq.Bass	SequenceBs
ClkSynBa	ClickSynBs
SynBs2Dk	SynBass2Dk
SmthSynB	SmthSynBas
ModulrBa	ModularBas
X WireBa	X WireBass
AtkPulse	AttakPulse
MetalBas	Metal Bass
F.OsciBa	FrcOsciBas
CubitBas	Cubit Bass
CubitBa+	CubitBass+
KeelBass	Keel Bass
PlnPulse	PlainPulse
PowerSaw	Power Saw
SynthAtk	SynthAttak
SmoothBs	SmoothBass
AnalgBa*	AnalogBas*
Oct.Bass	OctaveBass
PowerBas	Power Bass
SlwVioln	SlowViolin
CadenzDk	DarkCadnza
ViolinSc	ViolinSect
HdVlnSec	HardVlnSec
SlVlnSec	SlowVlnSec
Viola  *	Viola *
DblViola	DoublViola
ViolaSec	Viola Sect
HdVlaSec	HardVlaSec
SlVlaSec	SlowVlaSec
Cello  *	Cello *
CellSect	Cello Sect
HdCelloS	HdCelloSec
SlCelloS	SlCelloSec
ContrSec	ContrbSect
HdContrS	HdContrSec
SlContrS	SlContrSec
Contrbs*	Contrabas*
TremStr#	Trem.Str #
SlwTrStr	SlowTrmStr
Susp.Str	Susp. Str.
Fear Str	FearString
Det.Fear	DetuneFear
Apoclyps	Apocalypse
BrTrmStr	BrtTremStr
TremStr*	TremStrng*
LvTrmStr	LvTremStr.
PizzOct.	PizzOctave
Harp   *	Harp *
Hakbrett	Hackbrett
YangChin	Yang Chin
ElecHarp	Elec. Harp
VlinHarp	ViolinHarp
DtVliHrp	DtViolnHrp
Roll&Hit	Roll & Hit
Strngs1#	Strings 1#
StStrngs	St.Strings
Slow Str	SlowString
SforzStr	SfzStrings
Arco Str	ArcoString
60sStrng	60s'String
Orch.Str	OrchString
OrchStr2	OrchStrng2
TremOrch	Trem.Orch.
Velo.Str	VeloString
Stacc.Hi	StaccatoHi
Stacc.Hi	StaccatoHi
Stacc.Hi	StaccatoHi
Stacc.Lo	Low Stacc.
SolidStr	SolidStrng
SwellStr	Swell Str.
3 OctStr	3 Oct.Str.
5PartStr	5-Part Str
StrngEns	StringsEns
OrchStr*	OrchStrng*
Strngs2#	Strings 2#
StSlwStr	St.SlowStr
LegatoSt	Legato Str
Warm Str	WarmString
70s Str	70s'String
Strings3	Strings 3
ChmbrStr	ChamberStr
StrQuart	StrQuartet
Marcato*	MarctoStr*
ArcoStr*	Arco Str.*
ZephyrS.	ZephyrStr.
Reso Str	Reso. Str.
Syn.Str3	SynthStr.3
Monarchy	MonarchySt
GrandPad	Grand Pad
SweepStr	SweepStrng
Syn.Str4	SynthStr.4
Syn.Str5	SynthStr.5
SynStr1*	SynthStr1*
TradeWnd	Trade Wind
WormHole	Worm Hole
TaurusS.	TaurusStr.
Leo Str.	Leo String
SolPlexs	SolrPlexus
St.Choir	Ste. Choir
ChoirAh2	Choir Ah 2
MelChoir	MelloChoir
ChoirStr	Choir Str.
StereoAh	Stereo Aah
VoiceDoo	Voice Doo
VoiceHmm	Voice Hmm
StereoOh	Stereo Ooh
SynVoix2	Syn.Voice2
AnalgVox	AnalgVoice
OrchHit2	Orch. Hit2
ImpactHt	Impact Hit
Brs Stab	Brass Stab
DoublHit	Double Hit
BrsStb80	BrasStab80
BassHit+	Bass Hit +
6th Hit	Sixth Hit
6th Hit+	6th Hit +
EuroHit+	Euro Hit +
OrchHit*	Orch. Hit*
Trumpet#	Trumpet #
Trumpet2	Trumpet 2
BriteTrp	Bright Trp
Warm Trp	Warm Trmpt
Dark Trp	Dark Trmpt
SftDkTrp	SoftDrkTrp
Soft Trp	Soft Trmpt
BlownTrp	BlownTrmpt
DblBlwTp	DblBlowTrp
SweetTrp	SweetTrmpt
MlSwtTrp	Mel.SwtTrp
NormlTrp	Normal Trp
Bril Trp	Brill. Trp
FlugelHr	FlugelHorn
SoloTrp*	SoloTrmpt*
SwtTrmpt	SweetTrmpt
Trombon#	Trombone #
Trombon2	Trombone 2
BrtTromb	BrtTrombon
MelloTrb	MelloTromb
BrilTrmb	Brill.Trmb
HardTrmb	HardTrombn
BrtBsTrb	BriteBsTrb
HrdBsTrb	HardBsTrmb
TromSect	TrombnSect
HardTuba	Hard Tuba
SlowTuba	Slow Tuba
Eufonium	Euphonium
MutedTp#	MutedTrp #
MuteTrp2	MutedTrp 2
FrHrSolo	FrHornSolo
FrHorn 2	Fr. Horn 2
HornOrch	Horn Orch.
Syn.Horn	SynthFrHrn
HrnOrch2	Horn Orch2
BrtFrHrn	BriteFrHrn
HardFrHr	HardFrHorn
BrsSect#	BrassSect#
StBrsSec	StBrasSect
SforzBrs	SforzBrass
MildBras	Mild Brass
Tp&TbSec	Trp&TrbSec
TpTbSec2	Trp&TbSec2
BrasFall	Brass Fall
BrsSect2	BrassSect2
Hi Brass	High Brass
MelloBrs	MelloBrass
SuperBrs	SuperBrass
CutBrass	SpBrassCut
Tenor&Tp	Tenor&Trp
Alps Brs	Alps Brass
SymphBrs	SymphBrass
PhoenxBr	Phoenix Br
BrsSect*	BrassSect*
QuackBrs	QuackBrass
RezSynBr	ResoSynBrs
PolyBras	Poly Brass
SynBras3	SynthBras3
AnlSforz	AnalgSforz
JumpBras	Jump Brass
SyBrsSub	SynBrasSub
AnVelBrs	An.VeloBrs
AnalgBrs	AnalogBras
SynBras*	SynthBras*
TechnoBr	TechnoBras
HbrCmpBr	HybridComp
SoftBras	Soft Brass
SynBras4	SynthBras4
ChoirBrs	ChoirBrass
Ana.Horn	AnalogHorn
AnVelBr2	AnVeloBrs2
AnalBrs2	AnalogBrs2
Medit.Sx	MeditateSx
SprnoSx*	Sopr. Sax*
SwtSprno	SwtSoprano
AltoSax#	Alto Sax #
LgtAltSx	LgtAltoSax
Sax Sect	Sax Sect.
HyprAlto	Hyper Alto
PwrAltSx	PowerAltSx
FakeAlto	Fake Alto
FakeAlt+	Fake Alto+
DFakeAlt	DrkFakeAlt
AltoSax*	Alto Sax *
SwtAltSx	SwtAltoSax
BrthTnSx	BrthyTnrSx
SoftTenr	SoftTenrSx
TenrSax2	TenorSax 2
SuperTnr	SuperTenor
SuprTnr+	SuperTenr+
SupTnrSt	SuprTnrSt.
Tenr&Alt	Tenor&Alto
BrthTnr2	BrthyTenr2
SwtTenor	SweetTenor
BariSax*	Bari. Sax*
HeinzUni	HeinzUnisn
Exp.Oboe	Expr. Oboe
BasClari	BassClari.
Piccolo*	Piccolo *
NeatBrth	NeatBreath
BthBoehm	BrthyBoehm
Pastoral	Pastorale
SwtFlute	SweetFlute
PanFlut#	Pan Flute#
PanFlut2	PanFlute 2
SwtPanFl	SwtPanFlut
BotlLgto	BotlLegato
SqrLead2	SquareLd 2
LMSquare	LM Square
HollowSq	Hollow Sqr
ShmoogLd	ShmoogLead
DblOsci.	DoublOsci.
MellowSq	Mellow Sqr
SoloSine	Solo Sine
SineLead	Sine Lead
Pulse Ld	Pulse Lead
SyncLead	Sync Lead
AccentLd	AccentLead
AlumLead	Alum Lead
FMSlwSwp	FMSlwSweep
Curse Ld	Curse Lead
OctvBeep	OctaveBeep
MiniLead	Mini Lead
Vinyl Ld	Vinyl Lead
SawLead2	Saw Lead 2
ThickSaw	Thick Saw
Dyna.Saw	DynamicSaw
Digi.Saw	DigitalSaw
HeavySyn	HeavySynth
WaspySyn	WaspySynth
RezzySaw	Rezzy Saw
DoublSaw	Double Saw
Dim Saw	Dim Saw Ld
PulseSaw	Pulse Saw
Dr. Lead	DoctorLead
VeloLead	Velo. Lead
Dunce Ld	Dunce Lead
Str8Puls	StraitPuls
ModulSaw	ModularSaw
SimplSaw	Simple Saw
SeqAnalg	Seq.Analog
SawLead*	Saw. Lead*
Analogon	AnalogonLd
FireWire	Fire Wire
Early Ld	Early Lead
Fargo Ld	Fargo Lead
NoviceLd	NoviceLead
VentSyn.	Vent Synth
PureLead	Pure Lead
ElecPrim	ElecPrimtv
SaltLead	Salt Lead
HardSync	Hard Sync
DistLead	Dist. Lead
WireLead	Wire Lead
SynPluck	SynthPluck
DaSyncLd	DaSyncLead
SynthAah	Synth Aah
Vox Lead	Voice Lead
BrthLayr	BreathLayr
5thLdSft	5thLeadSft
Big&Low	Big & Low
Fat&Prky	Fat&Perky
SftWhirl	Soft Whirl
ThickPad	Thick Pad
RotarStr	Rotary Str
LightPad	Light Pad
PolyPd80	PolyPad 80
ClickPad	Click Pad
AnalgPad	Analog Pad
SquarePd	Square Pad
Light Pd	Light Pad
CosmicPd	Cosmic Pad
GlassPad	Glass Pad
SqrTwang	Sqr. Twang
Sqr.Pad8	Sqr. Pad 8
ChorusPd	Chorus Pad
Shwimmer	ShwimmerPd
Converge	ConvergePd
PolarPad	Polar Pad
Celstial	Celestial
Wv2001Pd	Wave 2001
ClaviPad	Clavi. Pad
HrmoRain	Harmo.Rain
AfrcWind	AfricaWind
Ancestrl	Ancestral
SynDrCmp	CompSynDrm
TinyBell	Tiny Bells
RndGlock	RoundGlock
GlokChim	GlockChime
ClearBel	Clear Bell
ChorBell	Choir Bell
SynMalet	SynthMalet
SftCryst	SoftCrystl
LoudGlok	Loud Glock
XmasBell	Xmas Bells
VibraBel	VibrafnBel
DigiBell	Digi. Bell
AirBells	Air Bells
BellHarp	Bell Harp
Gamelmba	Gamelimba
AnalgBel	AnalogBell
WarmAtms	Warm Atmos
HollwRls	Hollow Rls
NylonEP.	Nylon EP.
NylnHarp	Nylon Harp
Harp Vox	Harp Voice
AtmosPad	Atmos. Pad
DigiBmda	DigiBermda
CloudPad	Cloud Pad
PulseKey	Pulse Key
NoisePno	NoisePiano
FantaBel	FantasyBel
ShinStar	Shine Star
Brt.Stab	Brite Stab
BellPad*	Bell Pad *
GobSynth	GoblnSynth
ToHeaven	To Heaven
MilkyWay	Milky Way
GblnTalk	GoblinTalk
BelChoir	Bell Choir
Echoes 2	EchoDrops2
EchoBell	Echo Bells
SynPiano	SynthPiano
StarDust	Star Dust
Reso&Pan	Reso.&Pan.
Ana.Echo	AnalogEcho
DetSitar	Det. Sitar
Syn.Raga	Synth Raga
Sitar  *	Sitar *
MuteBnjo	MutedBanjo
ElecBnjo	Elec.Banjo
Gopichnt	Gopichant
Banjo  *	Banjo *
Shmisen*	Shamisen *
TaishoKn	Taisho-Kin
Koto   *	Koto *
BigKlmba	BigKalimba
Hichriki	Hichiriki
TiklBell	TickleBell
Gamelan	GamelanGon
S.Gameln	St.Gamelon
RamaCymb	RamaCymbal
AsianBel	Asian Bell
Atargane	Atarigane
GlasPerc	Glass Perc
ThaiBell	Thai Bells
Gr.Cassa	Gran Cassa
Mel Tom2	Melo Tom 2
Tim'sSet	Tim's Set
AnalgTom	Analog Tom
ElecPerc	Elec. Perc
Syn.Perc	Synth Perc
RvCymbl2	RevCymbal2
RvCymbl3	RevCymbal3
RevSnare	Rev. Snare
RvSnare2	Rev.Snare2
Rev.Kick	Rev. Kick
RConBaDr	RvConBaDrm
Rev. Tom	ReverseTom
Rev.Tom2	Rev. Tom 2
MtdClavi	MutedClavi
DstnFire	DistntFire
Lightnin	Lightning
TinKettl	Tin Kettle
BlineHrd	Hard Bline
TnglCaos	TinglChaos
VanAllen	Van Allen
BlowNoiz	Blow Noise
K/S Ana.	K/S Analog
Monastry	Monastery
Incontnc	Incontince
Prcesion	Precession
K/S Hum.	K/S Humid
IncntClk	IncntClick
RndmWalk	RandomWalk
Lust St.	StereoLust
K/S Slap	Kk/Sn Slap
CheapOsc	CheapOsci.
RandmRun	Random Run
SoftHit+	Soft Hit +
Rvr/Crsh	Rev./Crash
NastyCut	Nasty Cut
CheapOc+	CheapOsci+
CalcOrg1	CalcOrgan1
NstyCtSt	NastyCutSt
NstOrSpl	NastyOrSpl
CalcOrg2	CalcOrgan2
Xe	Xenon
SprClick	SuperClick
CalcOrg3	CalcOrgan3
Ruin St.	StereoRuin
OrganHit	Organ Hit
ChoCalcO	ChorCalcOr
Malfnctn	Malfnction
OrgnHit+	Organ Hit+
ChoirSpl	SplitChoir
UnvrsSwp	UniversSwp
VaporVox	VaporVoice
Xe +	Xenon Plus
VoxShoot	VoiceShoot
SemiacOr	SemiAcouOr
Refusal+	Refusal +
EnvyShrt	Short Envy
DoubtDbl	DoublDoubt
Glocken+	Glocken +
CutNoise	Cut Noise
CutNoiz2	CutNoise 2
DstCutNz	DstCutNoiz
Str.Slap	StringSlap
B.Slide	Bass Slide
P.Scrape	PickScrape
Fl.KClik	FltKyClick
HorseGlp	HorseGalop
BirdTwit	Bird Tweet
PhonCall	Phone Call
DoorSqek	DoorSqueak
DoorSlam	Door Slam
ScratchC	ScratchCut
Scratch2	ScratchSpl
WindChim	Windchimes
TeleFon2	Telephone2
Scratch3	Scratch 3
Turntabl	Turn Table
Turntabl	Turn Table
CarStart	Car Start
CarTyreS	CarTyreSq.
Car Pass	CarPassing
CarCrash	Car Crash
JetPlane	Jet Plane
Submarin	Submarine
Connect	Connctvity
LaughVox	Laugh Vox
ScreamVx	Scream Vox
Heart	Heartbeat
Footstep	Footsteps
Applauz2	Applause 2
Applauz2	Applause 2
MchinGun	MachineGun
LaserGun	Laser Gun
Xplosion	Explosion
Firework	Fireworks
SFX Kt 2	SFX Kit 2
TechnoKt	Techno Kit
TechnoHi	TechnoKtHi
TechnoLo	TechnoKtLo
SakuraKt	Sakura Kit
S. Latin	SmallLatin
ChinaKit	China Kit
AfroCuba	AfroCubaKt
AfrCuba2	AfrCubaKt2
BrazilKt	Brazil Kit
PopLatin	PopLatinKt
StndKit#	Standard #
BrightKt	Bright Kit
RogueKit	Rogue Kit
DarkRoom	DarkRoomKt
RockKit2	Rock Kit 2
ElectrKt	ElectroKit
AnalgKt2	AnalogKit2
DanceKit	Dance Kit
HipHopKt	Hip Hop Kt
JungleKt	Jungle Kit
ApogeeKt	Apogee Kit
PerigeKt	PerigeeKit
JazzKit2	Jazz Kit 2
BrushKit	Brush Kit
BrushKt2	BrushKit 2
SymphnKt	SymphonyKt
Ntrl Kit	NaturalKit
NtrlFunk	NtrlFunkKt
TrampKit	Tramp Kit
AmberKit	Amber Kit
CoffinKt	Coffin Kit
Lv StdKt	LiveStdKit
LvFunkKt	LiveFunkKt
Lv Brush	LvBrushKit
Std&Perc	LvStd&Perc
FunkPerc	LvFunkPerc
Brush&P.	LvBrush&P.
RockKit3	Rock Kit 3
LiveRm A	LiveRoom A
LiveRm B	LiveRoom B
GrdPnoSt	GrandPnoSt
RchGrdSt	RichGrndSt
TghtGdSt	TightGrdSt
DavidPno	DavidPiano
BobPiano	Bob Piano
PnoStPad	PianoStPad
StRichSt	StRichSt
ChorDigi	ChorusDigi
Trem. CP	Tremolo CP
Hnkytnk1	Honkytonk1
Sweetnes	Sweetness
Dyno 83	Dynamic 83
60s' EP	60s' EP.
ChorTine	ChorusTine
90Ballad	90s Ballad
DXEP+Cho	DXEP+Chor.
RichHpsi	RichHarpsi
PhaseClv	PhaseClavi
VintLead	Vintage Ld
SpaceZoo	Space Zoo
Gtr Hero	GuitarHero
StoneHng	Stonehenge
Whizzer	WhizzerBas
SimpleBa	SimpleBass
ClavBass	Clavi.Bass
SuperBas	Super Bass
New Slap	NewSlapBas
RockPigs	Rock Pigs
Cybastrg	Cybastring
Wynth	WindySynth
Buzz Saw	Buzzy Saw
Zub Zub	ZubZubLead
BlueLead	Blue Lead
OsciLead	Oscil.Lead
SqrLead!	Square Ld!
BiggerSy	BiggerSyn.
AnaSquid	AnalgSquid
SharpSyn	SharpSynth
Ana.Wave	AnalogWave
Ana.Wurl	AnalgWurly
FngrBas!	FingerBas!
UprghtBa	UprightBas
Fnground	GrndFingrd
Birdland	BirdlandBs
FlageoBa	FlageoBass
DampBass	Damp Bass
Fretles!	Fretless!
Fretls!2	Fretless!2
ThumBass	Thump Bass
RockBass	Rock Bass
SmooBass	SmoothBas!
WarmBass	Warm Bass
YamaBass	YamahaBass
Bass Cab	Bass Cab.
FruitBas	FruityBass
AcidBas!	Acid Bass!
SqrBass!	SquareBas!
PlsClav!	PulseClav!
MogueBas	Mogue Bass
BoppaBas	Boppa Bass
BuzzerBa	BuzzerBass
MuteHrBa	MutedHrtBa
Tek.Bass	TeknoBass!
TranzBas	TranceBass
Chamlion	Chamelion
Para.Syn	Para.Synth
SteamBas	Steam Bass
WhelkBas	Whelk Bass
AttakSyn	AttakSynth
Q. Klav	Q.Klavinet
India	IndiaSitar
YamSteel	Yama Steel
Stung St	StungStrng
Waterfon	Waterphone
DinoPerc	Dino Perc.
Formula	FormulaCar
Jurassic	JurassicDn
Devil	Devil's
SpcHorse	SpaceHorse
Suedhead	Suedehead
EspaGtr!	EspagnGtr!
JazzGtr!	JazzGuitr!
JazzyGtr	Jazzy Gtr.
WetPluck	Wet Pluck
Comp.Gtr	Compr.Gtr.
FunkyGtr	Funky Gtr.
Thin Gtr	ThinGuitar
Carlos	CarlosGtr.
Destiny	DestinyGtr
Grunge	GrungeLead
Ossyncro	OsciSyncro
Sync Ld!	Sync Lead!
Old Mini	Old MiniLd
Fat Mini	Fat MiniLd
Parlopho	Parlophone
SimpleSy	SimpleSyn.
Choronic	ChoronicLd
SlitMinu	SlitMinute
SynHarmo	SynthHarmo
Syn.Skex	Synth Skex
Reso.Sqr	ResoSquare
Wurli Ld	Wurli Lead
FlatLead	Flat Lead
ChalPuls	ChalPulsLd
Pluck Ld	Pluck Lead
Brassyn	BrassSynth
AcoSynLd	Acou.SynLd
Digitron	DigitronLd
LyricOff	Lyrics Off
Rezzawi	Rezzawi Ld
Claribo	Claribone
Binafone	Binaphone
MokoPipe	Moko Pipe
Persinet	PersianClr
PicoPipe	Pico Pipe
Softblow	SoftBlowSx
AlbaPipe	Alba Pipe
Edgeopho	Edgeophone
BaClari!	BassClari!
WX Clari	WXClarinet
WX JzGtr	WX JazzGtr
Shakuha!	Shakhachi!
LipClari	LipClarint
Floboe	Fluid Oboe
Sintax	Sintax Sax
Eastern	EasternShk
SprnoSx!	SopranoSx!
LiteAlto	Light Alto
Trombon!	Trombone!
BtlFlute	BottlFlute
Air Sax	Airy Sax
TenorSx!	Tenor Sax!
Coca	Coca PFlu.
JetLpBow	JetLipBow
Viol Inn	Violin Inn
MuteCone	Muted Cone
BrethBow	BreathyBow
Trumpt!2	Trumpet! 2
FluglHr!	FlugelHrn!
Jazz Trp	JazzTrumpt
JazzTrp2	JazzTrump2
WXTrumpt	WX Trumpet
MuteTrp!	MutedTrpt!
MuteTp!2	MutedTrp!2
MelTrmbn	MelTrombon
NerzoBrs	NerzoBrass
FrchHrn!	FrenchHrn!
FrHorn!2	FrnchHrn!2
Nu Horne	New Horne
WX Horn	WX Fr Horn
NuViolin	New Violin
C Violin	Con.Violin
BrtVioln	BriteVioln
MutedVln	MutedVioln
BrtViola	BriteViola
Vla Outt	Viola Outt
Eleanor	EleanorCel
Nu Cello	New Cello
Contrair	ContrairBa
DoublBow	DoublBowCB
Picolo!2	Piccolo! 2
BowPicol	BowedPicol
C Flute	CncrtFlute
C Flute2	Con.Flute2
JazFlute	Jazz Flute
OakFlute	Oak Flute
BtlFlut2	BotlFlute2
Rzde.Flt	Rzde.Flute
Nz Flute	NoisyFlute
WX Shaku	WX Shakuha
PanPicol	PanPiccolo
Bamboo	Bamboo Di
Andean	AndesQuena
SoftReed	Soft Reed
SquealAT	SquealinAT
NuSoprSx	NewSoprSax
CvSoprSx	CurvSoprSx
SoprPipe	SoprnoPipe
LiteSopr	LiteSoprno
AnaSprno	AnalogSopr
NuAltoSx	NewAltoSax
SweetAlt	Sweet Alto
AltoSax!	Alto Sax!
HarpAlto	Harp Alto
HarpAlt2	Harp Alto2
GlassAlt	Glass Alto
Wack Sax	Wacky Sax
NuTenrSx	New Tenor
MildTenr	Mild Tenor
GlassTnr	GlassTenor
FunkyTnr	FunkyTenor
OldTenor	Old Tenor
BrtTenor	BriteTenor
BariSax!	Bari. Sax!
VoxoSaxo	Voxo Saxo.
Oboe!2	Oboe! 2
OboeWhi.	Oboe Whi.
DblReedy	DoublReedy
TripleRd	TriplReedy
EngHorn!	Eng. Horn!
Clrinet!	Clarinet!
LitePipe	Light Pipe
HyperCla	HyperClari
Clrint!2	Clarinet!2
IslePipe	Isle Pipe
ThaiReed	Thai Reed
Recordr!	Recorder!
Claricrd	Clarichord
SoftPipe	Soft Pipe
BowedSaw	Bowed Saw
MizuHorn	Water Horn
Pico Str	PicoString
Sylophon	Sylophone
Bowed Ld	Bowed Lead
Squeeze	SqeezAcord
MouthKey	Mouth Key
AmpdHarp	AmpedHarmo
CromHarp	ChromHarmo
WahUpHrp	WahUpHarmo
YamaBotl	YamaBottle
CrumBon	CrumTrombn
ReedWin	Reedy Wind
M-ASoft	M-AdltSoft
M-AHusky	M-AdtHusky
F-NMusic	F-NewMusic
F-Coquet	F-Coquette
Turn Tbl	Turn Table
SideStck	Side Stick
Deep Snr	Deep Sonar
SumohDrm	Sumoh Drum
DX-Grwl1	DX-Growl 1
DX-Grwl2	DX-Growl 2
JnglBell	JingleBell
DX-Ring1	DX-Ring 1
DX-TlCal	DX-TelCal.
DX-TlBsy	DX-TelBusy
DX-TlTne	DX-TelTone
DX-Ring2	DX-Ring 2
DX-BigBn	DX-Big Ben
DX-RvCy1	DX-RevCym1
DX-RvCy2	DX-RevCym2
DX-Hlcpt	DX-Helicpt
MotrCycl	MotorCycle
Scrchers	Scratchers
DX-Flght	DX-Flight
MobyDick	Moby Dick
OutLimit	OuterLimit
MM-Shk 2	MM-Shake 2
Flxatone	Flexatone
WhikShot	Whisk Shot
PercShot	Perc. Shot
StreetSD	StreetSDrm
ManEater	Man Eater
SmbaWhsl	SambaWhisl
Refs Wsl	RefsWhistl
Triangl1	Triangle 1
Triangl2	Triangle 2
SlighBel	SlightBell
FrtePno1	FortePno.1
FrtePno2	FortePno.2
MM-Pno 2	MM-Piano 2
El.Grd 1	El.Grand 1
El.Grd 2	El.Grand 2
El.Grd 3	El.Grand 3
El.Grd 4	El.Grand 4
DX-Road1	DX-Rhode 1
DX-Road2	DX-Rhode 2
DX-Road3	DX-Rhode 3
DX-Road4	DX-Rhode 4
Det.EP 1	Det. EP 1
Det.EP 2	Det. EP 2
Det.EP 3	Det. EP 3
Det.EP 4	Det. EP 4
Det.EP 5	Det. EP 5
Det.EP 6	Det. EP 6
Det.EP 7	Det. EP 7
Det.EP 8	Det. EP 8
Det.EP 9	Det. EP 9
Det.EP10	Det. EP 10
AD1900s1	AD1900s' 1
MM-Clav3	MM-Clavi.3
Hallowen	Halloween
MM-Clsta	MM-Celesta
Syn.Glok	SynGlocken
DX-MsBx1	DXMusicBx1
DX-MsBx2	DXMusicBx2
DX-MsBx3	DXMusicBx3
DX-MsBx4	DXMusicBx4
DX-MsBx5	DXMusicBx5
DX-MsBx6	DXMusicBx6
DX-MsBx7	DXMusicBx7
DX-MsBx8	DXMusicBx8
MM-Vibr2	MM-Vibra.2
DX-Mrmb1	DX-Mrimba1
DX-Mrmb2	DX-Mrimba2
DX-Mrmb3	DX-Mrimba3
DX-Mrmb4	DX-Mrimba4
DX-Mrmb5	DX-Mrimba5
DX-Mrmb6	DX-Mrimba6
DX-Mrmb7	DX-Mrimba7
MiniBell	Mini Bells
DumBells	Dum Bells
CrystBel	CrystalBel
SilkRoad	Silk Road
DX-Acrd1	DX-Accord1
DX-Acrd2	DX-Accord2
DX-Acrd3	DX-Accord3
DX-Acrd4	DX-Accord4
DX-Acrd5	DX-Accord5
DX-Acrd6	DX-Accord6
DX-ClGt1	DX-ClrGt.1
DX-ClGt2	DX-ClrGt.2
DX-ClGt3	DX-ClrGt.3
DX-ClGt4	DX-ClrGt.4
DX-ClGt5	DX-ClrGt.5
DX-ClGt6	DX-ClrGt.6
DX-ClGt7	DX-ClrGt.7
DX-ClGt8	DX-ClrGt.8
DX-ClGt9	DX-ClrGt.9
DXClGt10	DX-ClrGt10
DXClGt11	DX-ClrGt11
BassLgnd	BassLegend
HardFngr	HardFngrBa
DX-PkBa1	DX-PickBa1
DX-PkBa2	DX-PickBa2
DX-PkBa3	DX-PickBa3
DX-PkBa4	DX-PickBa4
CompedEB	CompedE.Ba
BassMgic	Bass Magic
SuprBas1	SuperBass1
SuprBas2	SuperBass2
DX-Vla 1	DX-Viola 1
DX-Vla 2	DX-Viola 2
DX-Vla 3	DX-Viola 3
DX-Harp1	DX-Harp 1
DX-Harp2	DX-Harp 2
DX-Harp3	DX-Harp 3
Apollon	ApollonHrp
CmbaHarp	CmbalmHarp
Violtron	Violintron
General	GeneralStr
MM-Vce 4	MM-Voice 4
DX-Clar1	DX-Clari.1
DX-Clar2	DX-Clari.2
DX-Clar3	DX-Clari.3
DX-Bottl	DX-Bottle
DX-SLd 9	DX-SqrLd 9
DX-SyLd1	DX-Syn.Ld1
DX-SyLd2	DX-Syn.Ld2
DX-SyLd3	DX-Syn.Ld3
DX-SyLd4	DX-Syn.Ld4
DX-SyLd5	DX-Syn.Ld5
DX-SyLd6	DX-Syn.Ld6
DX-SyLd7	DX-Syn.Ld7
DX-SyLd8	DX-Syn.Ld8
DX-SyLd9	DX-Syn.Ld9
Dstrcted	Destructed
BellStr1	BellStrng1
BellStr2	BellStrng2
Chi-S&H1	Chiff-S&H1
DX-Echo1	DX-Echoes1
DX-India	DX-Indian
DX-Klmb1	DX-Klimba1
DX-Klmb2	DX-Klimba2
DX-Klmb3	DX-Klimba3
DX-Klmb4	DX-Klimba4
Twincle	TwincleBel
Cream Ba	Cream Bass
WonderBa	WonderBass
AnalgStr	Analog Str
MultiSaw	MultiSawSt
ANHardBr	ANHardBras
PulserLd	PulserLead
DirtySaw	Dirty Saw
J.Hammer	JackHammer
AbacabLd	AbacabLead
ANCowbel	AN Cowbell
Radio Nz	RadioNoise
FreeEdge	Free Edge
AnalgAge	Analog Age
FreeRthm	FreeRhythm
BPF Step	BPF Steps
Dist.5th	Dist.Fifth
HardNoiz	Hard Noise
Celuloid	Celluloid